#######################################################################################
#               #                        #                    #                       #
#               #                        # ################   # ##                    #
#               #                        # #                  # ##                    #
#               #                        #                # # # ##                    #
#               #                        ######## ####### # #   ##                    #
#               #                        #              # # ######                    #
######## #########################       #  #    ##   # # # #    #                    #
#           #####                #       #  # # ##### ### ####   #################### #
#           #####                #       #  # #       #                               #
#           #####                #       #### ###### ### ############################ #
#                                        #           #   #                     #      #
#           #####                #       # #### ### ## ###                       ######
#           ######################          #     #    ###                     #      #
## ################################################################################## #
#   #                  #  #          #       ## ####     ###                   #      #
#   #                  # ##          #       ##          ###                       ####
#   # #                #             #           ###     ###                          #
#   # #                #             #       ## ####     ###                          #
#   # #                #             #       ## ####     ###                          #
#   # #                #             #       ## ####     ###                          #
#   # #                #                     ## ####     ###                          #
#   # #                #             ################### ###                          #
#     #                #             #                     #                          #
#   ###                #             #                     #                          #
#   # #                #             #                     #                          #
#   # #                #             #                    ##                          #
#   # ################ #             #                 #  ##                          #
#   #     #          #   ############# #########       #  ##                          #
#   # #   #   ###### #####           #         #       #  ##                          #
#   # #   #   #       ####           #         #       #  ##                          #
#   # #       #       ####           #         #       #  ##                          #
#   # #   #   #       ####           #         #       #  ##                          #
##### #       #       ####           #         #       #  ##                          #
#     #   #   #       ####           # #########       #  ##                          #
#   # #   #   #                        #               #  ##                          #
#   # #       #                      ####       ########  ##                          #
#######################################################################################